3 8 3
@@@..@@W
@@...@..
@@@....|
..@@@..W
|@@@@...
........
W@@@@...
..@@...@
....$@@@