7 7 1
@@@@@@@
@W..@.$
@.@|@.@
@...|.@
@.@|@.@
@..|..@
@@@@@@@
