7 7 2
@@@@@@@
@W..@.|
@.@.@.@
@...@.@
@.@.@.@
@.....@
@@@@@@@
@@@@@@@
@.....@
@.@.@.@
@...@.@
@.@.@.@
@W..@.|
@@@@@@@
